11111111111111111111
10000100000000100001
10110101111110101101
10100000000000000101
10101100000000110101
10000000000000000001
10101100000000110101
10100000000000000101
10110111100111101101
10000100000000100001
10000100000000100001
10110111111111101101
10100000000000000101
10101100000000110101
10000000000000000001
10101100000000110101
10100000000000000101
10110100000000101101
10000100000000100001
11111111111111111111